---MAP-START---
VERSION:2
SIZE:48
CELL:100
ORIGIN:-2400,-2400
POSE:50,100,45000
STATS:1280,879,145
DATA:0000000000000000000000000000000000000000000000000000000000000000
     0000000000000000000000000000000000000000000000000000000000000000
     0000000000000000000000000000000000000000000000000000000000000000
     0000000000000000000000000000000000000000000000000000000000000000
     0000000000000000000000000000000000000000000000000000000000000000
     0000000000000000000000000000000000000000000000000000000000000000
     0000000000000000000000000000000000000000000000000000000000000000
     0000000000000000000000000000000000000000000000000000000000000000
     0000000000000000000000000000000000000000000000000000000000000000
     0000000000000000000000000000000000000000000000000000000000000000
     0000000000000000000000000000000000000000000000000000000000000000
     0000000000000000000000000000000000000000000000000000000000000000
     0000000000000000505050505050505050505050505050505050505050505050
     50505050505050500000000000000000000000000000000050e0e0e0e0e0e0e0
     e0e0e0e0e0e0e0e0e0e0e0e0e0e0e0e0e0e0e0e0e0e0e0500000000000000000
     000000000000000050e0e0e0e0e0e0e0e0e0e0e0e0e0e0e0e0e0e0e0e0e0e0e0
     e0e0e0e0e0e0e0500000000000000000000000000000000050e0e0e0e0e0e0e0
     e0e0e0e0e0e0e0e0e0e0e0e0e0e0e0e0e0e0e0e0e0e0e0500000000000000000
     000000000000000050e0e0e0e0e0e0e0e0e0e0e0e0e0e0e0e0e0e0e0e0e0e0e0
     e0e0e0e0e0e0e0500000000000000000000000000000000050e0e0e0e0e0e0e0
     e0e0e0e0e0e0e0e0e0e0e0e0e0e0e0e0e0e0e0e0e0e0e0500000000000000000
     000000000000000050e0e0e0e0e0e0e0e0e0e0e0e0e0e0e0e0e0e0e0e0e0e0e0
     e0e0e0e0e0e0e0500000000000000000000000000000000050e0e0e0e0e0e050
     5050e0e0e0e0e0e0e0e0e0e0e0e0e0e0e0e0e0e0e0e0e0500000000000000000
     000000000000000050e0e0e0e0e0e0505050e0e0e0e0e0e0e0e0e0e0e0e0e0e0
     e0e0e0e0e0e0e0500000000000000000000000000000000050e0e0e0e0e0e050
     5050e0e0e0e0e0e0e0e0e0e0e0e0e0e0e0e0e0e0e0e0e0500000000000000000
     000000000000000050e0e0e0e0e0e0e0e0e0e0e0e0e0e0e0e0e0e0e0e0e0e0e0
     e0e0e0e0e0e0e0500000000000000000000000000000000050e0e0e0e0e0e0e0
     e0e0e0e0e0e0e0e0e0e0e0e0e0e0e0e0e0e0e0e0e0e0e0500000000000000000
     000000000000000050e0e0e0e0e0e0e0e0e0e0e0e0e0e0e0e0e0e0e0e0e05050
     505050e0e0e0e0500000000000000000000000000000000050e0e0e0e0e0e0e0
     e0e0e0e0e0d0d0d0d0d0d0d0e0e050e0e0e0e0e0e0e0e0500000000000000000
     000000000000000050e0e0e0e0e0e0e0e0e0e0e0e0d0d0d0d0d0d0d0e0e050e0
     e0e0e0e0e0e0e0500000000000000000000000000000000050e0e0e0e0e0e0e0
     e0e0e0e0e0d0d0d0d0d0d0d0e0e050e0e0e0e0e0e0e0e0500000000000000000
     000000000000000050e0e0e0e0e0e0e0e0e0e0e0e0d0d0d0d0d0d0d0e0e0e0e0
     e0e0e0e0e0e0e0500000000000000000000000000000000050e0e0e0e0e0e0e0
     e0e0e0e0e0d0d0d0d0d0d0d0e0e0e0e0e0e0e0e0e0e0e0500000000000000000
     000000000000000050e0e0e0e0e0e0e0e0e0e0e0e0d0d0d0d0d0d0d0e0e0e0e0
     e0e0e0e0e0e0e0500000000000000000000000000000000050e0e0e0e0e0e0e0
     e0e0e0e0e0d0d0d0d0d0d0d0e0e0e0e0e0e0e0e0e0e0e0500000000000000000
     000000000000000050e0e0e0e0e0e0e0e0e0e0e0e0e0e0e0e0e0e0e0e0e0e0e0
     e0e0e0e0e0e0e0500000000000000000000000000000000050e0e0e0e0e0e0e0
     e0e0e0e0e0e0e0e0e0e0e0e0e0e0e0e0e0e0e0e0e0e0e0500000000000000000
     000000000000000050e0e0e0e0e0e05050e0e0e0e0e0e0e0e0e0e0e0e0e0e0e0
     e0e0e0e0e0e0e0500000000000000000000000000000000050e0e0e0e0e0e050
     50e0e0e0e0e0e0e0e0e0e0e0e0e0e0e0e0e0e0e0e0e0e0500000000000000000
     000000000000000050e0e0e0e0e0e0e0e0e0e0e0e0e0e0e0e0e0e0e0e0e0e0e0
     e0e0e0e0e0e0e0500000000000000000000000000000000050e0e0e0e0e0e0e0
     e0e0e0e0e0e0e0e0e0e0e0e0e0e0e0e0e0e0e0e0e0e0e0500000000000000000
     000000000000000050e0e0e0e0e0e0e0e0e0e0e0e0e0e0e0e0e0e0e0e0e0e0e0
     e0e0e0e0e0e0e0500000000000000000000000000000000050e0e0e0e0e0e0e0
     e0e0e0e0e0e0e0e0e0e0e0e0e0e0e0e0e0e0e0e0e0e0e0500000000000000000
     000000000000000050e0e0e0e0e0e0e0e0e0e0e0e0e0e0e0e0e0e0e0e0e0e0e0
     e0e0e0e0e0e0e0500000000000000000000000000000000050e0e0e0e0e0e0e0
     e0e0e0e0e0e0e0e0e0e0e0e0e0e0e0e0e0e0e0e0e0e0e0500000000000000000
     000000000000000050e0e0e0e0e0e0e0e0e0e0e0e0e0e0e0e0e0e0e0e0e0e0e0
     e0e0e0e0e0e0e050000000000000000000000000000000005050505050505050
     5050505050505050505050505050505050505050505050500000000000000000
     0000000000000000000000000000000000000000000000000000000000000000
     0000000000000000000000000000000000000000000000000000000000000000
     0000000000000000000000000000000000000000000000000000000000000000
     0000000000000000000000000000000000000000000000000000000000000000
     0000000000000000000000000000000000000000000000000000000000000000
     0000000000000000000000000000000000000000000000000000000000000000
     0000000000000000000000000000000000000000000000000000000000000000
     0000000000000000000000000000000000000000000000000000000000000000
     0000000000000000000000000000000000000000000000000000000000000000
     0000000000000000000000000000000000000000000000000000000000000000
     0000000000000000000000000000000000000000000000000000000000000000
     0000000000000000000000000000000000000000000000000000000000000000
---MAP-END---
